{
    "map": [
        ["g", "1", "1", "1", "o", "1", "1", "o", "1", "1", "1", "g"],
        ["a", " ", " ", " ", " ", " ", " ", " ", " ", " ", " ", "a"],
        ["1", "w", " ", "3", "3", " ", " ", "3", "3", " ", "w", "1"],
        ["a", "1", " ", "3", "t", " ", " ", "t", "3", " ", "1", "a"],
        ["t", "o", " ", " ", " ", "3", "3", " ", " ", " ", "o", "t"],
        ["1", "1", " ", " ", "3", "2", "2", "3", " ", " ", "1", "1"],
        ["g", "w", " ", " ", "3", " ", " ", "3", " ", " ", "w", "g"],
        ["1", "1", "1", " ", " ", " ", " ", " ", " ", "1", "1", "1"],
        ["1", "1", "1", "1", "o", "1", "1", "o", "1", "1", "1", "1"],
        ["1", "t", "o", "1", "1", "1", "1", "1", "1", "o", "t", "1"],
        ["a", " ", " ", " ", " ", " ", " ", " ", " ", " ", " ", "a"]
    ]
}
