{
    "map": [
        ["t", "t", "t", "t", "t", "t", "t", "t", "t", "t", "t", "t", "t"],
        ["t", " ", " ", " ", " ", " ", " ", " ", " ", " ", " ", " ", " "],
        ["t", " ", " ", " ", " ", " ", " ", " ", " ", " ", " ", " ", " "],
        ["t", "t", "t", "t", "t", "t", "t", "t", "t", "t", "t", "t", "t"],
        [" ", " ", " ", " ", " ", " ", " ", " ", " ", " ", " ", " ", "t"],
        [" ", " ", " ", " ", " ", " ", " ", " ", " ", " ", " ", " ", "t"],
        ["t", "t", "t", "t", "t", "t", "t", "t", "t", "t", "t", "t", "t"]
    ]
}
